* * * * * * * * * * * * * * * * * * * * * * * * * * * * * * * * * * * * * * * * * * * * * * * * * *
*       *   *   *               *               S                             *               *   *
*       *   *           *       *                                             *               *   *
*       *   *   *       *                                                     *               *   *
*       *   *   *       *       *                                                             *   *
*           *   *   * * * *   * * * * * * * * * * * * * *   * * * * * * * * * * * *   * * * * *   *
*       *   *   *       *       *                           *                 *   *           *   *
* *   * * * *   * * * * * *   * * *   * * * *   * * *                         *           *   *   *
*       *   *   *         *     *       *   *       *   * * * * * *   * * * * *   *   * * *   *   *
*       *   *   *               *       *   *       *       *         *                   *   *   *
*       *   *   *         *     *           *       *                 *       *   *       *   *   *
*       *   *   *         *     * *   * * * *       *       *         *       *   *       *   *   *
*       *   *   *         *     *                   *       *                 *   *       *       *
*       *   *             *     *       *   *       *       * * *   * * *   * *   * * * * * * *   *
*       *   *   *         *     *       *   *       *       *         *       *           *   *   *
*       *   *   *         *     * * *   * * * * * * *   * * * * * * * * * * * *               *   *
*       *   *   * * * *   *   * *                                             *           *   *   *
*       *   *   *         *     *                   *                         *           *   *   *
*       *   * * * * * * * * *   * * * * * * * * * * * *   * * * * * * * * * * * * * * * * * * *   *
*       *   *             *     *                           *                                 *   *
*       *   *                                                                                 *   *
*       *   *             *     *                           *                                 *   *
*       *   * * * * *   * *   * * * * * *   * * * * * * * * * * * * * * * * * * * * * *   * * *   *
*       *   *             *     *                           *                                 *   *
*       *   * * * * * * * * * * * * * *   * * E * * * * * * * * * * * * * * * * * * * * * * * * * *
*       *   *                 *             *     *                                           *   *
*       *   *                                     *                                           *   *
*       *   *                 *             *                                                 *   *
*       *   * * * *   * * * * *   * * * * * *     *                                           *   *
*       *   *                               *   * * * * * * * * * * * * * * * * * *   * * * * *   *
*       *                     *             *     *                                               *
*       *   * * * * * * * * * * * * * *   * * * * * * *   * * * * * * * * * * * * * * * * * * *   *
*       *   *                                                                                 *   *
*           *                               *                                                 *   *
*       *   *                               *                                                 *   *
* * *   * * * * * * * * * * * * * * * * * * * * * * * * * * * * * * * * * * * * * * * *   * * * * *
*   *       *                                   *                                                 *
*   *       *                                                                                     *
*           * * * * * * * * * * * * * * *   * * * * * * * * * * * * * * * * * * *   * * * * * * * *
*   *       *                                   *                                   *             *
*   *       *                 *                 *                                                 *
*   *   * * * * * * * *   * * *   * * * * * * * *                                   *             *
*   *       *                 *           *     *                                   *             *
*   *       *       *             *       *     * *   * * * * * * * * * * * * * * * *   * * * * * *
*           *       *         *   * *   * *     *                                                 *
*   *       *       *         *                 *   * * * * * * * * * * *   * * * * *   * * * * * *
*   *         * *   *   * * * *   *       *     *                                   *             *
*   *       *                 * * * * *   *   *             *                       *         *   *
*   *       *       *         *           *     *           *                       *         *   *
* * * * * * * * * * * * * * * * * * * * * * * * * * * * * * * * * * * * * * * * * * * * * * * * * *
