* * * * * * * * * * * * * * * * * * * * * * * * * * * * * * * * * * * * * * * * * * * * * * * * * *
*     *                   *         *                       *                 *       *           *
*                         *         *                                         *                   *
*     *                   *         *                       *                 *   * * * *   * * * *
* *   *   * * * * * * * * *         * * * * * * * * * *   * * * * * * * *   * *       *           *
*     *                   *         *                                                             *
*             *           *         *                       *                 *       *           *
*     *   * * * *   * * *           *                       *                 *       *           *
*     *                   *         * * * *   * * * * * * * * * * * * * * * * * * *   * * * * * * *
*     *       *           *         *                                         *             *     *
* * * *   * * * * * * * * *   * * * * * * * * * *   * * * * * * * * * * * * * *             *     *
*                                   *                                     *                       *
*                         *         *                                         * * * * *   * *   * *
*                         *                                               *   *             *     *
* * * * * * * * * * *   * * * * * * * E * * *   * * * * * * * * * * * * * * * * * * * * * * * * * *
*                   *   *           *         *     *                   *           *       *     *
*         *         *   *       *   *                                   *                   *     *
*         *         *   *       *   *         * *   * * * * * * *   * * *   * * * * *   * * *     *
*         *         *   *       *             *                         *   *       *       *     *
*         *         *   *       *   *         *     *                   *                   *     *
*         *         *   *       *   * *   * * * * * *   * * * * * * * * *   *       *             *
*         *         *   *       *   *         *       *       *             *   * * *       *     *
*         *         *   *       *   *         *       *       *         *   *       *       *     *
*         *         *   * * *   * * *         *       *       *         * * *   * * * * * * *   * *
*         *         *   *       *   *         *               *         *               *   *     *
*         *         *   *       *   *         *   * * *   * * *         *                         *
*         *             *       *   *         *               *         *               *   *     *
*         *         *   *       *   *         *       *       *         * * * * * * *   * * *     *
*         *         *           *   *         *       *                 *               *   *     *
*         *         *   *       *   *         * * * * * * *   * * *   * *     *         *   *     *
*         *         *   *       *   *                         *         *     *         *   *     *
*         *         *   *       *   *         *               *         *     *             *     *
*         *         *   *       *   *         *                         * *   * *   * * *   *     *
*         *         *   *           *         *               *         *     *         *   *     *
*         *         *   *       *   * * * * * * * * * * * * * *   * * * * * * *   * * * * * * * * *
*         *         *   *       *   *                       *           *           *       *     *
*         *         *   *       *   *   * * * *   * * * *               *                   *     *
*         *         *   *       *   *       *     *     *   *           *           *       *     *
*         *         *   *       *   *       *     *     *   * * *   * * * * *   * * * *   * *     *
*         *         *   *       *   *       *           *   *   *       *                         *
*         *         *   *       *   *             *     *   *   *       *           *       *     *
*         *         *   *       *   *       *     *     *   *   *       * * *   * * * * * * *   * *
*         *         *   *       *   *       *   * *   * *   *           *                   *     *
*         *         *   *       *   *       *           *   *   *   * * *             *           *
* * *   * *   * * * *   * *   * * * *       *     *     *                   * * * * * *   * *     *
*         *         *   *           *       *     *     *   *   S       *             *     *     *
* * * * * * * * *   * * * * *   * * * * *   * * * * * * * * * * * *   * *             *     *     *
*                                   *                                   *                   *     *
*                   *               *                   *               *             *     *     *
* * * * * * * * * * * * * * * * * * * * * * * * * * * * * * * * * * * * * * * * * * * * * * * * * *
