* * * * * * * * * * * * * * * * * * * * * * * * * * * * * * * * * * * * * * * * * * * * * * * * * *
*   *       *                 *                                                                   *
*   *       *                 *                                                   E               *
*   *       *                 *                                                                   *
*   *       *                                                                                     *
*   *       * *   * * * * * * * * * * * * * * * * * * *   * * * * * * * * * * * * * * * * * * * * *
*   *       *       *     *   *                         *                           *             *
*   *       *             *   *                         *           *                             *
*   *       * *   * *   * *   *                                     *               *             *
*   *       *       *         *                         *           * * * * * * *   *   * * * * * *
*   *       *       *     *   * * * * * * * * * * *   * * * * *   * *     *         *     *       *
*   *       *             *   *                         *           *     *               *       *
*   *       *       *     *   *   *                     *   * *   * *               *     *       *
*   *       *   * * * * * * * *   * * * * * * * * *   * *     *     *     *         *             *
*   *       *         *   *   *                                     * *   *   * * * * *   *   * * *
*   *       *         *   *   *   *                     *     *     *     *         *     *       *
*   *       *             *   *   * * * * * * * * * * * * * * * * * * * *   * * * * * * * * * * * *
*   *       *         *   *   *                       *             *       *     *         *     *
*   *       *         *   *   *               *       *     *       *       *     *         *     *
*           *         *   *   *               *       *     *       *       *     *               *
*   *       *         *   *   * * * *   * * * * *   * *     *       *       *               *     *
*   *       *         *   *   *               *       *     *       *       *   * *   * * * *     *
*   *       *         *   *   *     *                       *               *               *     *
*   *       *         *   *   *     *         *       *   * * *   * *       *     *         *     *
*   *       *         *   *   *     *         *       *     *       *       *   * * * * * * *   * *
*   *       *         *       *   * * * *   * *       *     *       *       *   *           *     *
*   *   * * *         *   *   *     *         *       *             *       *               *     *
*   *       *         *   *   *     *         *       *     *       *       *   *                 *
*   *       *         *   *   *               *       *     *       *       *   *           *     *
*   *       *         *   *   *     *         *       *     *       *       *   *   * * * * *     *
*   *       *         *   *     *   * * * * * * * * * * * * *   * * *           *           *     *
*           *         *   *   *                       *         *   *       *   *   *   * * *     *
*   *       *         *   *   * * * * *   * * * *   * *         *   *       *       *       *     *
*   *                 *   *   *               *                     *       *   *           *     *
*   *       *   * * * * * *   *               *       *         *   *       *   *   *       *     *
*   *       *             *   *                       * *   * * * * * * *   * * * * * * *   * * * *
*   *       *         *   *   *               *       *         *   *       *                     *
*   * * * * * * * * * * * * * * * * * * * * * * * * * * * *   * * * * * * * * * * * * * * * * * * *
*           *                     *                                                               *
* * *   * * *                               * * * *   * * *   * * * * * * * * * * * * * * * * * * *
*           *                     *         *             *                           *           *
*       *   * * *   * * * * * * * * *   * * * * *   * * * *                           *           *
*       *                         * S       *         *   *                           *           *
*       *   *   * * * * * * *   * *         *         *   *                                       *
*       *   *                               *             * * * * *   * * * * * * * * *   * * * * *
*       *   *               *     *         *         *                                           *
*       *   *               *     *         *         *   *                           *           *
*       *   * * * * * * * * * * * * *   * * * * * * * * * * * * * * * * * * * *   * * * * * * * * *
*       *   *                               *                                                     *
* * * * * * * * * * * * * * * * * * * * * * * * * * * * * * * * * * * * * * * * * * * * * * * * * *
