********************************
*         *                    *
*    *    *  ****************  *
*    *    *    *               *
*    *    *    *               *
*    *    *    *    *********  *
*    * *  *    *          *    *
**     *       *          *    *
*****  *********      *   *    *
*              *   *  *   **   *
*    ******  ***   *           *
*    *    *    *   *           *
*    *    *    *   ******      *
*    *    *    *               * 
*    *    *    *************   *
*        **** **               *
*******        *         *******   
*         *    *   ***         * 
*    *    *  ***       * *******    
*    *    *    *       *       *
*    *    *    *               *
*    *    *    *********       *
*    *        S*E              *
********************************
