**************************************************
*       *                   *    *  *    *   * * *
*                  *        *    *  *    *     * *
*** ****** *********                *    *   * * *
*   *        *  *  S****** **** **  *    *   * * *
*   *   *    *  *  * *  *        *       * ***** *
*   *   *    *  *  *    *   *    *  *    *   * * *
*       *    *     * *  *   *    *  *    *     * *
*   *   *       *  * *      *    *  *    *   *   *
*   *   ** *** **  * ** * ***    *  *    *   * * *
*** ** **    *  *  * *  *   *    *  *    *   * * *
*       ******* * ** ***** **    *  *    *   * * *
*   *   *       *  * *      *    *  *    *   * * *
**** ************************* **** *** **   * * *
*                                *       *   * * *
*                  *             *  *    * *******
*                  *             *  *    *     * *
********************* ************ *******     * *
*                                                *
*                                *       *     * *
************** **************************** ******
*      *                              *  *   *   *
*                                     *  *   *   *
****** ******** *********************E*  *   *   *
*    * *        *             *     *    *   *   *
*    *                        *       *  *   *   *
*      *        *             **** ****  *       *
*    * *        *             *       *  *   *   *
*    * ******* ************ *** *   * *  *   *   *
** *****        *               *   * *  *   *   *
*      *                      * ** ** *  *   *   *
*    * *        *             * *   * *  *   *   *
*    * **** ********************** ****  * *** ***
*    * *                      *       *  *   *   *
************************* ************* **   *   *
*                                     *  *   *   *
*                                 *   *  *   *   *
*                                 *   *  *   *   *
*********************** ************ **  *   *   *
*                    *            *      *       *
*                                 *   *  *   *   *
*                    *            *   *  *   *   *
*                    *            *   *      *   *
******************* ********** ****   *  *   *   *
*                    *            *   *  *   *   *
** ******* *********** ******* ****   *  *   *   *
*                    * *              *  *   *   *
*  *                              *   *  *   *   *
*  *                 * *          *   *  *   *   *
**************************************************
