* * * * * * * * * * * * * * * * * * * * * * * * * * * * * * * * * * * * * * * * * * * * * * * * * *
*                 *         *                                                                     *
* * * *   * *   * *                                                                               *
*   S       *     * *   * * * * * * * * * * * * * * * * * * * * * * * * * * * *   * * * * * * * * *
*                                                                                                 *
*           *     *         *                                                                     *
* * * * * * *   * * * * * * * * * * * * * * * * * * * * * * * * * *   * * * * * * * * * * * * * * *
*       *         *                                                                               *
*       *         *                     *                 *             *                         *
*                 * *   * * * * * * * * * * *   * * * * * *             *                         *
*   * * * * *   * *                                       * * *   * * * * * * * * * *   * * * * * *
*       *         *                     *                 *             *                         *
*       *         * * * * * * * * * * * *   * * * * * * * * * * * * * * * * * * * * * *   * * * * *
*       *         *                                       *     *       *             *       *   *
*       *         * * * *   * * * * * * * *   * * *             *                     *       *   *
*       *         *                   *           *       *     *   * * * * * * *   * *           *
*                 *               *   *       *   *       *     *                     *       *   *
*       *         * * * * *   * * * * * * *   * * *       *     *       *   *         *   * * * * *
*       *         *                               *       *     *       *   *         *           *
*       *         *               *   *       *   *       *     *       *   *         *       *   *
*       *         * *   * * * * * * * * * * * * * * *   * *     *       *   *         *       *   *
*       *         *       *                       *       *     *       *   *         *       *   *
*       *         *       *   * *   * * * * * * * *       *     *       *   *                 *   *
*       *         *           *                   *       *     *       *   *         *       *   *
*       *         *       *   *   * *   * * * * * *       *             *   *         *       *   *
*       *         *       *         *             *       *     *       *   *         *       *   *
*       *         *       *   *     *             *       *     *       *   *         *       *   *
*       *         *       *   *                   *       *     *       *   *         *       *   *
*       *         *       *   *     *             *       *     *       *   *         *       *   *
*       *         * * *   * * * *   * * * * * * * *       *     *       *   *         *       *   *
*       *         *       *                 *     *       *     *       *   *   * * * *       *   *
*       *         *       *                 *     *       *     *       *             *       *   *
*       *         *       *                       *       *     *       *   *         *       *   *
*       *         *       * * *   * * * * * *   * *       *     * * * * * *   * * * * * * *   * * *
*       *         *       *   *       *     *     *       *     *                     *   *       *
*       *         *       *   *       *     *     *       *     * *   * * * *   * * * *           *
*       *         *       *   *             *     *       *     *         *           *   *       *
*       *         *       *   *       *     *     *       *     *         *       *   *   *       *
*       *                 *           *           *       *     *         * * *   * * *   * *   * *
*       *         *       *   * *   * *     *     *       *     *                                 *
*       *         *       *           *     *     *       *     *         *       *   *   *       *
*       *         *       *   *       *     *     *       *   * * * * * * * * *   * * * * * * * * *
*       *         *       *   *       *     *             *     *   *                             *
*       *         *       * * * *   * *   * *     *       *     *                                 *
*       *         *       *           *     *     *       *     *   *                             *
*       *         *       *   *             *     *       *     *   *                           E *
*       *         *           * *   * *     *     *       *     *   * * * * *   * * * * * * * * * *
*       *         *       *           *     *     *       *                                       *
*       *         *       *   *       *     *     *       *     *   *                             *
* * * * * * * * * * * * * * * * * * * * * * * * * * * * * * * * * * * * * * * * * * * * * * * * * *
