* * * * * * * * * * * * * * * * * * * * * * * * * * * * * * * * * * * * * * * * * * * * * * * * * *
*       *       *     *         *                         *   *       *               *           *
*               *     *                                   *           *                           *
*       *       *     * *   * * * * * * * * * *   * * * * *   *       * * * * *   * * *   * * * * *
*       *       *     *             *                     *   *       *   *           *   *       *
*       *             *         *   *                     *   *       *               *   *       *
*       *       *     *         *   *                     *   *       *   * * *   * * *   *       *
*       *       *     *         *                         *   *   * * *   *       *   *   *       *
*       *       *     *         *   * * * *   * * * * * * *   *       *   *       *   *           *
*       *       *     *         *   *                         *       *   *           *   *       *
*       *       *     *         *   *   * *   * * * * * * *   *       *   *       *   *   *   * * *
*       *       *               *       *                 *   *       *   *   * * * * *   *       *
*       *       *     *         *   *                     *               *       *   *           *
*       *       *     *         *   *   *                 *   *       *   *       *   *   *       *
*   * * * *   * *     *         *   *   *                 *   *       *   *       *   *   *       *
*       *       *   * * * *   * * * * * * * * * * * * * * *   *       *   *       *       *       *
*       *       *     *                       *           *   *       *               *   *       *
*       *       *         *           *       *           *   *       *   *       *   *   *       *
*       *       *     *   *           *                   * * * *   * * * * * *   * * * * * * * * *
*               *     *   *   * * * * *       *           *     *     *                           *
*       *       *     *               *   * * * * * *   * *     *     *                       *   *
*       *       *     *   *           *       *           *           * * *   * * * * * * * * * * *
*       *       *     *   * * * * * * * *   * * * * * * * *     *                             *   *
*       *       *     *                                   *   * *   * *                           *
*       *       *     *               *                   *           *                       *   *
*       *       *     *               *                   *     *     *                       *   *
*       *       * * * * * * *   * * * * * * * * * * * * * * * * * * * * * * * * * * *   * * * * * *
*       *       *                                         *                                       *
*       *       *                                                                                 *
*       *       *                                         *                                       *
* * *   * * * * * * * * * * * * * * * * * * * * * * * * * * * *   * * * * * * * * * * * * * * * * *
*         *     *                                                                                 *
*         *     *                                                                       *         *
*         *     *                                                                       *         *
*               * * * * * * * * * * * * * * * * * * * * * * * * *   * * * * * * * * * * *   * * * *
*         *     *                                                                       *         *
*         *     * * * * * * * * * * * * * * * * * * * * *   * * * * * * * * * * *   * * *         *
*         *     *                         *                                 *           *         *
*         *       * *   * * * * * *   * * *                 *                       *   *         *
*         *     *           *             * * * * *   * * * * *   * * * * * *       *   *         *
*         *     *                                                           *       *   *         *
*         *     *           *             *                 *               *       *   *         *
*         *     * * * * * * * * * *   * * * * * * * * * *   * * * * * * * * *       *             *
*         *     *                         *                                 *       *   *         *
*         *     *   * * * *   * * * * * * *   * * * * * *   * * * * * * * * * * *   * * *         *
*         *     *                         *                                 *           *         *
*         *     *         *                     *                           *       *   *         *
* * *   * *   * *         *               *     *                           *       *   *         *
*         *     *         *               *     *                           *       *   *         *
* * * * * * * * * * * * * * * * * * * * * * * * * * * * * * * * * * * * * * * * * * * * * * * * * *
