**************************************************
*  *  *    *    * S                 * * *    *   *
*  *  *    *    *                                *
*  *  *    *    *                   * * ** ***   *
*  *  *                             * *      *   *
*  *  *    **** ************* ******* * *    *   *
*  *  *    *    *    *              * * *    *   *
*     *    *    *                   * *** ***** **
*  *       *    * ********* ********* *          *
*  ** * ****    *    *              * *      *   *
*  *       *                        * ****** *****
*  *  *    *    *    *              *            *
*  *  *    *    *    *              * *          *
*  ******* ******************* ****** *          *
*  *       *                        * *          *
*  **** ************************************** ***
*  *      *                      *  *  *         *
*  *                                *  *         *
*  *      *                      *  *            *
*  ** ***************** **********  * ******* ****
*  *      *                      *               *
*  * ***************************** **  *         *
*  *                             *  *  *         *
* ****************************************** *****
*  *   * *         *                      * *    *
*  *               *                      * *    *
*  *   * *                                * *    *
*  *   * *** **************** ************* *    *
*  *   * *                                *      *
*  *   * *         *                      * *    *
*  *   * *************** ****************** *    *
*  *   *                                  * *** **
*  *   * *                                * *    *
*  * ****************************** ******* *    *
*  *   *                                    *    *
*  *                                      *      *
*  *   *                                  * *    *
*  *   *                                  * *    *
*  ********* ********************************** **
*  *  *        *         *                *  *   *
*  *           * *** *****      *                *
*  *  *            *     *      *         * ** ***
*  *  *        *         ***** **** *******  *   *
*  * ***** *****   *            *         *  *   *
*  *  *        *   *     *                *  *   *
*  ***** ************** **      *         *      *
*  *           *         *      *         *  *   *
*   *** ************************** ********  *   *
*  *                     E                *  *   *
**************************************************
